w28
h15
x8
y8
............................
............................
............................
............????............
............................
............................
........????....????........
............................
............................
.......BBBBBBBBBBBBBB.......
.......BBBBBBBBBBBBBB.......
.......BBBBBBBBBBBBBB.......
.......BBBBBBBBBBBBBB.......
............................
............................