w28
h15
x8
y8
............................
............................
............................
............____............
............................
............................
........____....____........
............................
............................
.......BBBBBBBBBBBBBB.......
.......BBBBBBBBBBBBBB.......
.......BBBBBBBBBBBBBB.......
.......BBBBBBBBBBBBBB.......
............................
............................