w256
h16
x2
y11
G..........................................................................................................................................................................................GGGGGGGGGG..........................................................G
G..........................................................................................................................................................................................GGGGGGGGGG..........................................................G
G..........................................................................................................................................................................................GGGGGGGGGG..........................................................G
G............................................................GGG.................................................GGGGG.....................................................................GGGGGGGGGG..........................................................G
G.............................................................G..................................................GGGGG................................___.......___........................GGGGGGGGGG..........................................................G
G....................................................G........G........G.........................................GGGGG......______...................................................................................................________________..........G
G....................................................G........G........G.........................................GGGGG.........................................................................................................................................G
G..................................GGG...............GGGGGGGGGGGGGGGGGGG.........._____.........._____...........GGGGG...............................................................................................................________________..........G
G................x.................GGG...............G........G........G.........................................GGGGG..........................GGGGG.....GGGGG.....GGGGG..................GGGGGGGGGG..........................................................G
G...........GGGGGGGGGG.............GGG........................G..................................................GGGGG..........................GGGGG.....GGGGG.....GGGGG..................GGGGGGGGGG................................________________..........G
G..........GGGGGGGGGGGG............GGG........................G..................................................GGGGG..........................GGGGG.....GGGGG.....GGGGG..................GGGGGGGGGG..........................................................G
G.........GGGGGGGGGGGGGG...........GGG....................B...G.d................................................GGGGG.t........................GGGGG.....GGGGG.....GGGGG..................GGGGGGGGGG......GGG...GGG...GGG..................................w..G
GGGGGGGGGGGGGGGGGGGGGGGGGGGGGGGGGGGGGGGGGGGGGGGGGGGGGGGGGGGGGGGGGGGGGGGGGGGGG..............................GGGGGGGGGGGGGGGGGGGGGGGGGGGGGGGG.....GGGGG.....GGGGG.....GGGGG.....GGGGGGGGGGGGGGGGGGGGGGG.......G.....G.....G.........GGGGGGGGGGGGGGGGGGGGGGGGGGGGGG
GGGGGGGGGGGGGGGGGGGGGGGGGGGGGGGGGGGGGGGGGGGGGGGGGGGGGGGGGGGGGGGGGGGGGGGGGGGGG..............................GGGGGGGGGGGGGGGGGGGGGGGGGGGGGGGG.....GGGGG.....GGGGG.....GGGGG.....GGGGGGGGGGGGGGGGGGGGGGG.......G.....G.....G.........GGGGGGGGGGGGGGGGGGGGGGGGGGGGGG
GGGGGGGGGGGGGGGGGGGGGGGGGGGGGGGGGGGGGGGGGGGGGGGGGGGGGGGGGGGGGGGGGGGGGGGGGGGGG..............................GGGGGGGGGGGGGGGGGGGGGGGGGGGGGGGG.....GGGGG.....GGGGG.....GGGGG.....GGGGGGGGGGGGGGGGGGGGGGG.......G..s..G.....G.........GGGGGGGGGGGGGGGGGGGGGGGGGGGGGG
GGGGGGGGGGGGGGGGGGGGGGGGGGGGGGGGGGGGGGGGGGGGGGGGGGGGGGGGGGGGGGGGGGGGGGGGGGGGG..............................GGGGGGGGGGGGGGGGGGGGGGGGGGGGGGGG.....GGGGG.....GGGGG.....GGGGG.....GGGGGGGGGGGGGGGGGGGGGGG.......G.....G.....G.........GGGGGGGGGGGGGGGGGGGGGGGGGGGGGG