w256
h16
x2
y11
G..............................................................................................................................................................................................................................................................G
G..............................................................................................................................................................................................................................................................G
G................................................................................................................GGGGG.........................................................................................................................................G
G.............................................................G..................................................GGGGG.........................................................................................................................................G
G.............................................................G..................................................GGGGG.........................................................................................................................................G
G.............................................................G..................................................GGGGG.........................................................................................................................................G
G.............................................................G..................................................GGGGG.........................................................................................................................................G
G..................................GGG...............GGGGGGGGGGGGGGGGGGG..........GGGGG..........GGGGG...........GGGGG.........................................................................................................................................G
G..................................GGG...........................................................................GGGGG.........................................................................................................................................G
G...........GGGGGGGGGG.............GGG...........................................................................GGGGG.........................................................................................................................................G
G..........GGGGGGGGGGGG............GGG...........................................................................GGGGG.........................................................................................................................................G
G...w.....GGGGGGGGGGGGGG...........GGG...........................................................................GGGGG.........................................................................................................................................G
GGGGGGGGGGGGGGGGGGGGGGGGGGGGGGGGGGGGGGGGGGGGGGGGGGGGGGGGGGGGGGGGGGGGGGGGGGGGG..............................GGGGGGGGGGGGGGGGGGGGGGGGGGGGGGGGGGGGGGGGGGGGGGGGGGGGGGGGGGGGGGGGGGGGGGGGGGGGGGGGGGGGGGGGGGGGGGGGGGGGGGGGGGGGGGGGGGGGGGGGGGGGGGGGGGGGGGGGGGGGGGGGGGGGG
GGGGGGGGGGGGGGGGGGGGGGGGGGGGGGGGGGGGGGGGGGGGGGGGGGGGGGGGGGGGGGGGGGGGGGGGGGGGG..............................GGGGGGGGGGGGGGGGGGGGGGGGGGGGGGGGGGGGGGGGGGGGGGGGGGGGGGGGGGGGGGGGGGGGGGGGGGGGGGGGGGGGGGGGGGGGGGGGGGGGGGGGGGGGGGGGGGGGGGGGGGGGGGGGGGGGGGGGGGGGGGGGGGGGG
GGGGGGGGGGGGGGGGGGGGGGGGGGGGGGGGGGGGGGGGGGGGGGGGGGGGGGGGGGGGGGGGGGGGGGGGGGGGG..............................GGGGGGGGGGGGGGGGGGGGGGGGGGGGGGGGGGGGGGGGGGGGGGGGGGGGGGGGGGGGGGGGGGGGGGGGGGGGGGGGGGGGGGGGGGGGGGGGGGGGGGGGGGGGGGGGGGGGGGGGGGGGGGGGGGGGGGGGGGGGGGGGGGGGG
GGGGGGGGGGGGGGGGGGGGGGGGGGGGGGGGGGGGGGGGGGGGGGGGGGGGGGGGGGGGGGGGGGGGGGGGGGGGG..............................GGGGGGGGGGGGGGGGGGGGGGGGGGGGGGGGGGGGGGGGGGGGGGGGGGGGGGGGGGGGGGGGGGGGGGGGGGGGGGGGGGGGGGGGGGGGGGGGGGGGGGGGGGGGGGGGGGGGGGGGGGGGGGGGGGGGGGGGGGGGGGGGGGGGG