w256
h16
x2
y11
G..........................................................................................................................................................................................GGGGGGGGGG..........................................................G
G..........................................................................................................................................................................................GGGGGGGGGG..........................................................G
G..........................................................................................................................................................................................GGGGGGGGGG..........................................................G
G............................................................GGG.................................................GGGGG.....................................................................GGGGGGGGGG..........................................................G
G.............................................................G..................................................GGGGG..............................._____....._____.......................GGGGGGGGGG..........................................................G
G.............................................................G..................................................GGGGG......_____...................................................................................................._____......_____..........G
G.............................................................G..................................................GGGGG.........................................................................................................................................G
G..................................GGG.......................GGG.................._____.........._____...........GGGGG..............................................................................................................._____......_____..........G
G................x.................GGG........................G..................................................GGGGG..........................GGGGG.....GGGGG.....GGGGG..................GGGGGGGGGG..........................................................G
G...........GGGGGGGGGG.............GGG........................G..................................................GGGGG..............GGG.........GGGGG.....GGGGG.....GGGGG..................GGGGGGGGGG................................_____......_____..........G
G..........GGGGGGGGGGGG............GGG........................G..................................................GGGGG.............GGGGG........GGGGG.....GGGGG.....GGGGG..................GGGGGGGGGG..........................................................G
G.........GGGGGGGGGGGGGG...........GGG....................B...G.d................................................GGGGG.t...........GGGGG........GGGGG.....GGGGG.....GGGGG..................GGGGGGGGGG......GGG...GGG...GGG..................................w..G
GGGGGGGGGGGGGGGGGGGGGGGGGGGGGGGGGGGGGGGGGGGGGGGGGGGGGGGGGGGGGGGGGGGGGGGGGGGGG..............................GGGGGGGGGGGGGGGGGGGGGGGGGGGGGGGG.....GGGGG.....GGGGG.....GGGGG.....GGGGGGGGGGGGGGGGGGGGGGG.......G.....G.....G.........GGGGGGGGGGGGGGGGGGGGGGGGGGGGGG
GGGGGGGGGGGGGGGGGGGGGGGGGGGGGGGGGGGGGGGGGGGGGGGGGGGGGGGGGGGGGGGGGGGGGGGGGGGGG..............................GGGGGGGGGGGGGGGGGGGGGGGGGGGGGGGG.....GGGGG.....GGGGG.....GGGGG.....GGGGGGGGGGGGGGGGGGGGGGG.......G.....G.....G.........GGGGGGGGGGGGGGGGGGGGGGGGGGGGGG
GGGGGGGGGGGGGGGGGGGGGGGGGGGGGGGGGGGGGGGGGGGGGGGGGGGGGGGGGGGGGGGGGGGGGGGGGGGGG..............................GGGGGGGGGGGGGGGGGGGGGGGGGGGGGGGG.....GGGGG.....GGGGG.....GGGGG.....GGGGGGGGGGGGGGGGGGGGGGG.......G..s..G.....G.........GGGGGGGGGGGGGGGGGGGGGGGGGGGGGG
GGGGGGGGGGGGGGGGGGGGGGGGGGGGGGGGGGGGGGGGGGGGGGGGGGGGGGGGGGGGGGGGGGGGGGGGGGGGG..............................GGGGGGGGGGGGGGGGGGGGGGGGGGGGGGGG.....GGGGG.....GGGGG.....GGGGG.....GGGGGGGGGGGGGGGGGGGGGGG.......G.....G.....G.........GGGGGGGGGGGGGGGGGGGGGGGGGGGGGG