w270
h16
x43
y5
...............GGG....................................................................GGGGGGGGGGGGGGGGGGGGG......GGG..........GGG........................................................................GGG...................GGG............................................
...............GGG....................................................................GGGGGGGGGGGGGGGGGGGGG...d..GGG..........GGG........................................................................GGG...................GGG............................................
...............GGG....................................................................GGGGGGGGGGGGGGGGGGGGG......GGG..........GGG..............s.........................................................GGG...................GGG............................................
...............GGG..............................................................______GGGGGGGGGGGGGGGGGGGGG......GGG....GGG...GGG...GGGGGGGGGGGGGGGGGGGGGGGGGGGGGGGGGGGGGGGG...........................GGGGG...................GGG............................................
...............GGG....................................................................GGGGGGGGGGGGGGGGGGGGG......GGG....GGG...GGG...........................................GGGG.........................GGG...................GGG..........................G.................
...............GGG....................................................................GGGGGGGGGGGGGGGGGGGGG......GGG....GGG...GGG..............t................................GGG......................GGG...................GGG..................G.......G.................
...............GGG....................................................................GGGGGGGGGGGGGGGGGGGGG......GGG....GGG...GGG.....GGGGGGGGGGGGGGGGGGGGGGGGGGGGGGGGGGGGGGGG.................................................GGG..............G...G.......G.................
..............................G..................................................................................GGG....GGG...GGG.............................................GGGGG............................................GGG..............G...G...G...G.................
..............................G..................................................................................GGG....GGG...GGG..............................................................................................GGG..............G...G...G...G............w....
..............................G..................................................................................GGG....GGG...GGG.......GGGGGGGGGGGGGGGGGGGGGGGGGGGGGGGGGGGGGGGGGGGGGGGGGGGGGGGGGGGGGGGGGGGGGGGGGGGGGGGGGGGGGGGGGGGGGGGGGGGGGGGGGGGGGGGGGGGGGGGGGGGGGGGGGGGGGG
GGGGGGGGGGGGGGGGGGGGGGGGGGGGGGGGGGGGG..................G...........G..................GGGGGGGGGGGGGGGGGGGGG......GGG....GGG...GGG.......GGGGGGGGGGGGGGGGGGGGGGGGGGGGGGGGGGGGGGGGGGGGGGGGGGGGGGGGGGGGGGGGGGGGGGGGGGGGGGGGGGGGGGGGGGGGGGGGGGGGGGGGGGGGGGGGGGGGGGGGGGGGGGGGGGGGGG
GGGGGGGGGGGGGGGGGGGGGGGGGGGGGGGGGGGGG..................G...........G..................GGGGGGGGGGGGGGGGGGGGG......GGG....GGG...GGG.......GGGGGGGGGGGGGGGGGGGGGGGGGGGGGGGGGGGGGGGGGGGGGGGGG.......GGGGGGGGGGGGGGGGGGGGGGGGGGGGGGGGGGGGGGGGGGGGGGGGGGGGGGGGGGGGGGGGGGGGGGGGGGGGGG
GGGGGGGGGGGGGGGGGGGGGGGGGGGGGGGGGGGGG..................G...........G..................GGGGGGGGGGGGGGGGGGGGG......GGG....GGG...GGG.......GGGGGGGGGGGGGGGGGGGGGGGGGGGGGGGGGGGGGGGGGGGGGGGGG.......GGGGGGGGGGGGGGGGGGGGGGGGGGGGGGGGGGGGGGGGGGGGGGGGGGGGGGGGGGGGGGGGGGGGGGGGGGGGGG
GGGGGGGGGGGGGGGGGGGGGGGGGGGGGGGGGGGGG..................G...........G..................GGGGGGGGGGGGGGGGGGGGG.............GGG.............GGGGGGGGGGGGGGGGGGGGGGGGGGGGGGGGGGGGGGGGGGGGGGGGG.......GGGGGGGGGGGGGGGGGGGGGGGGGGGGGGGGGGGGGGGGGGGGGGGGGGGGGGGGGGGGGGGGGGGGGGGGGGGGGG
GGGGGGGGGGGGGGGGGGGGGGGGGGGGGGGGGGGGG..................G...........G..................GGGGGGGGGGGGGGGGGGGGG.............GGG.............GGGGGGGGGGGGGGGGGGGGGGGGGGGGGGGGGGGGGGGGGGGGGGGGGGGGGGGGGGGGGGGGGGGGGGGGGGGGGGGGGGGGGGGGGGGGGGGGGGGGGGGGGGGGGGGGGGGGGGGGGGGGGGGGGGGGGG
GGGGGGGGGGGGGGGGGGGGGGGGGGGGGGGGGGGGG..................G...........G..................GGGGGGGGGGGGGGGGGGGGG.............GGG.............GGGGGGGGGGGGGGGGGGGGGGGGGGGGGGGGGGGGGGGGGGGGGGGGGGGGGGGGGGGGGGGGGGGGGGGGGGGGGGGGGGGGGGGGGGGGGGGGGGGGGGGGGGGGGGGGGGGGGGGGGGGGGGGGGGGGGG