w270
h16
x4
y3
......................................................................................GGGGGGGGGGGGGGGGGGGGG.......GGG.........GGG........................................................................GGG...................GGG............................................
......................................................................................GGGGGGGGGGGGGGGGGGGGG.......GGG.........GGG........................................................................GGG...................GGG............................................
......................................................................................GGGGGGGGGGGGGGGGGGGGG...d...GGG.........GGG..............s.........................................................GGG...................GGG............................................
.......B........................................................................______GGGGGGGGGGGGGGGGGGGGG.......GGG...GGG...GGG...##########################################.........................GGGGG...................GGG............................................
GGGGGGGGGGGGGGG.......................................................................GGGGGGGGGGGGGGGGGGGGG.......GGG...GGG...GGG........................................................................GGG...................GGG..........................G.................
GGGGGGGGGGGGGGGGGGGGGG................................................................GGGGGGGGGGGGGGGGGGGGG.......GGG...GGG...GGG..............t.........................................................GGG...................GGG..................G.......G.................
GGGGGGGGGGGGGGGGGGGGGG................................................................GGGGGGGGGGGGGGGGGGGGG.......GGG...GGG...GGG.....########################################.................................................GGG..............G...G.......G.................
GGGGGGGGGGGGGGGGGGGGGGGGG.....G...................................................................................GGG...GGG...GGG..............................................................................................GGG..............G...G...G...G.................
GGGGGGGGGGGGGGGGGGGGGGGGG.....G...................................................................................GGG...GGG...GGG..............................................................................................GGG..............G...G...G...G............w....
GGGGGGGGGGGGGGGGGGGGGGGGG.....G...................................................................................GGG...GGG...GGG.......GGGGGGGGGGGGGGGGGGGGGGGGGGGGGGGGGGGGGGGGGGGGGGGGGGGGGGGGGGGGGGGGGGGGGGGGGGGGGGGGGGGGGGGGGGGGGGGGGGGGGGGGGGGGGGGGGGGGGGGGGGGGGGGGGGGGGG
GGGGGGGGGGGGGGGGGGGGGGGGGGGGGGGGGGGGG..................G...........G..................GGGGGGGGGGGGGGGGGGGGG.......GGG...GGG...GGG.......GGGGGGGGGGGGGGGGGGGGGGGGGGGGGGGGGGGGGGGGGGGGGGGGGGGGGGGGGGGGGGGGGGGGGGGGGGGGGGGGGGGGGGGGGGGGGGGGGGGGGGGGGGGGGGGGGGGGGGGGGGGGGGGGGGGGGG
GGGGGGGGGGGGGGGGGGGGGGGGGGGGGGGGGGGGG..................G...........G..................GGGGGGGGGGGGGGGGGGGGG.......GGG...GGG...GGG.......GGGGGGGGGGGGGGGGGGGGGGGGGGGGGGGGGGGGGGGGGGGGGGGGGGGGGGGGGGGGGGGGGGGGGGGGGGGGGGGGGGGGGGGGGGGGGGGGGGGGGGGGGG.......GGGGGGGGGGGGGGGGGGGGG
GGGGGGGGGGGGGGGGGGGGGGGGGGGGGGGGGGGGG..................G...........G..................GGGGGGGGGGGGGGGGGGGGG.......GGG...GGG...GGG.......GGGGGGGGGGGGGGGGGGGGGGGGGGGGGGGGGGGGGGGGGGGGGGGGGGGGGGGGGGGGGGGGGGGGGGGGGGGGGGGGGGGGGGGGGGGGGGGGGGGGGGGGGG.......GGGGGGGGGGGGGGGGGGGGG
GGGGGGGGGGGGGGGGGGGGGGGGGGGGGGGGGGGGG..................G...........G..................GGGGGGGGGGGGGGGGGGGGG.............GGG.............GGGGGGGGGGGGGGGGGGGGGGGGGGGGGGGGGGGGGGGGGGGGGGGGGGGGGGGGGGGGGGGGGGGGGGGGGGGGGGGGGGGGGGGGGGGGGGGGGGGGGGGGGG.......GGGGGGGGGGGGGGGGGGGGG
GGGGGGGGGGGGGGGGGGGGGGGGGGGGGGGGGGGGG..................G...........G..................GGGGGGGGGGGGGGGGGGGGG.............GGG.............GGGGGGGGGGGGGGGGGGGGGGGGGGGGGGGGGGGGGGGGGGGGGGGGGGGGGGGGGGGGGGGGGGGGGGGGGGGGGGGGGGGGGGGGGGGGGGGGGGGGGGGGGGGGGGGGGGGGGGGGGGGGGGGGGGGGGG
GGGGGGGGGGGGGGGGGGGGGGGGGGGGGGGGGGGGG..................G...........G..................GGGGGGGGGGGGGGGGGGGGG.............GGG.............GGGGGGGGGGGGGGGGGGGGGGGGGGGGGGGGGGGGGGGGGGGGGGGGGGGGGGGGGGGGGGGGGGGGGGGGGGGGGGGGGGGGGGGGGGGGGGGGGGGGGGGGGGGGGGGGGGGGGGGGGGGGGGGGGGGGGG