w192
h32
x3
y28
...................................................................GGGGGGGGGGGGGGGGGGGGGGGGGGGGGGGGGGGGGGGGGGGGGGGGGGGGGGGGGGGGGGGGGGGGGG.......................................................
...................................................................GGGGGGGGGGGGGGGGGGGGGGGGGGGGGGGGGGGGGGGGGGGGGGGGGGGGGGGGGGGGGGGGGGGGGG.......................................................
.x..............................................................t..GGGGGGGGGGGGGGGGGGGGGGGGGGGGGGGGGGGGGGGGGGGGGGG....................GGG.x.................................................x...
............................................................GGGGGGGGGGGGGGGGGGGGGGGGGGGGGGGGGGGGGGGGGGGGGGGGGGGGGG....................GGG.......................................................
............__GGGGGGG__...................................GGGGGGGGGGGGGGGGGGGGGGGGGGGGGGGGGGGGGGGGGGGGGGGGGGGGGGGG....................GGG..............__GGGGGGG__..............................
..............GGGGGGG...........................GG..........G......GGGGGGGGGGGGGGGGGGGGGGGGGGGGGGGGGGGGGGGGGGGGGGG....................GGG................GGGGGGG................................
..............GGGGGGG...........................GG..........G......GGGGGGGGGGGGGGGGGGGGGGGGGGGGGGGGGGGGGGGGGGGGGGGGGGGGGGGGGGGGGGGG...GGG................GGGGGGG................................
............__GGGGGGG__............................................GGGGGGGGGGGGGGGGGGGGGGGGGGGGGGGGGGGGGGGGGGGGGGGGGGGGGGGGGGGGGGGG...GGG..............__GGGGGGG__..............................
..............GGGGGGG..............................................GGGGGGGGGGGGGGGGGGGGGGGGGGGGGGGGGGGGGGGGGGGGGGGGGGGGGGGGGGGGGGGG...GGG................GGGGGGG................................
..............GGGGGGG.................GG..................GG.......GGG......................GGG.......................................GGG................GGGGGGG................................
............__GGGGGGG__...............GG..................GG.......GGG......................GGG.......................................GGG..............__GGGGGGG__..............................
..............GGGGGGG..............................................GGG......................GGGx......................................GGG................GGGGGGG................................
..............GGGGGGG..............................................GGG......................GGGGGGG...................................GGG................GGGGGGG................................
............__GGGGGGG__.......................G.....G..............GGG......................GGG.......................................GGG..............__GGGGGGG__..............................
..............GGGGGGG.........................G.....G..............GGG......................GGG.......................................GGG................GGGGGGG................................
..............GGGGGGG.........................G.....G..............GGG...G..................GGG..........GGGGGGGGGGGGGGGGGGGGGGGGGG...GGG................GGGGGGG................................
............__GGGGGGG__..............GGGGGGGGGGGGGGGGGGGGGGGG......GGG...G..................GGG..........GGGGGGGGGGGGGGGGGGGGGGGGGG...GGG..............__GGGGGGG__..............................
..............GGGGGGG................GGGGGGGGGGGGGGGGGGGGGGGG......GGG...GGGGGGGGGGGGGGGGGGGGGG..........GGGGGGGGGGGGGG...............GGG................GGGGGGG................................
..............GGGGGGG................GGGGGGGGGGGGGGGGGGGGGGGG......GGG...GGGGGGGGGGGGGGGGGGGGGGGGGGG.....GG.......GGGGG...............GGG................GGGGGGG................................
............__GGGGGGG__............................................GGG...GGGGGGGGGGGGGGGGGGGGGGGGGGG.....GG.d.....GGGGG...GGGGGGGGGGGGGGG..............__GGGGGGG__..............................
..............GGGGGGG..............................................GGG...................................GGGGG....GGGGG...GGGGGGGGGGGGGGG................GGGGGGG................................
..............GGGGGGG...................B................B.........GGG...................................GGGGG....GGGGG...............GGG................GGGGGGG................................
..............GGGGGGG................GGGGGGG##########GGGGGGG......GGG...................................GGGGG....GGGGG...............GGG................GGGGGGG................................
............GGGGGGGGGGG..............GGGGGGG..........GGGGGGG......GGGGGGGGGGG...GGGGGGGGGGGGGGGGGGGGGGGGGGGGG....GGGGGGGGGGGGGGGGG...GGG.B............GGGGGGGGGGG..............................
...........cGGGGGGGGGGG..............GGGGGGG..........GGGGGGG......GGGGGGGGGGG...GGGGGGGGGGGGGGGGGGGGGGGGGGGGG....GGGGGGGGGGGGGGGGG...GGGGGG...........GGGGGGGGGGG..............................
..........GGGGGGGGGGGGGGG..........................................GGG................GGG................GG.......GGGGGGGGGGGGGGGGG...GGGGGG.........GGGGGGGGGGGGGGG.................G..........
..........GGGGGGGGGGGGGGG................................................................................GG.......G..................................GGGGGGGGGGGGGGG.............G...G...G......
........GGGGGGGGGGGGGGGGGGG..............................................................................GG.......G................................GGGGGGGGGGGGGGGGGGG...........GGGGGGGGG......
........GGGGGGGGGGGGGGGGGGG.x........................................................................s...GG.......G................................GGGGGGGGGGGGGGGGGGG...........G...G...G..w...
GGGGGGGGGGGGGGGGGGGGGGGGGGGGGGGGGGGGGGGGGGGGGGGGGGGGGGGGGGGGGGGGGGGGGGGGGGGGGGGGGGGGGGGGGGGGGGGGGGGGGGGGGGGGGGGGGGGGGGGGGGGGGGGGGGGGGGGGGGGGGGGGGGGGGGGGGGGGGGGGGGGGGGGGGGGGGGGGGGGGGGGGGGGGGGGG
GGGGGGGGGGGGGGGGGGGGGGGGGGGGGGGGGGG..G..G..G..G..G..G..G..G..G..G..GGGGGGGGGGGGGGGGGGGGGGGGGGGGGGGGGGGGGGGGGGGGGGGGGGGGGGGGGGGGGGGGGGGGGGGGGGGGGGGGGGGGGGGGGGGGGGGGGGGGGGGGGGGGGGGGGGGGGGGGGGGGG
GGGGGGGGGGGGGGGGGGGGGGGGGGGGGGGGGGG..G..G..G..G..G..G..G..G..G..G..GGGGGGGGGGGGGGGGGGGGGGGGGGGGGGGGGGGGGGGGGGGGGGGGGGGGGGGGGGGGGGGGGGGGGGGGGGGGGGGGGGGGGGGGGGGGGGGGGGGGGGGGGGGGGGGGGGGGGGGGGGGGG