w64
h256
x2
y252
................................................................
................................................................
..............................s.................................
.......................GGGGGGGGGGGGGGG..........................
......................GGGGGGGGGGGGGGGGG.........................
......................GGGGGGGGGGGGGGGGG.........................
.......................GGGGGGGGGGGGGGG..........................
................................................................
................................................................
................................................................
................................................................
................................................................
................................................................
................................................................
................................................................
................................................................
................................................................
................................................................
................................................................
................................................................
................................................................
................................................................
................................................................
................................................................
................................................................
................................................................
................................................................
................................................................
................................................................
................................................................
................................................................
................................................................
................................................................
................................................................
................................................................
................................................................
................................................................
................................................................
................................................................
................................................................
............................w...................................
......................GGGGGGGGGGGGG.............................
.....................GGGGGGGGGGGGGGG............................
.....................GGGGGGGGGGGGGGG............................
......................GGGGGGGGGGGGG.............................
................................................................
GGGGGGGGGGG.....GGGGGGGGGGGGGGGGGGGGGGGGGGGGGGGGGGGGGGGGGGGGGGGG
.G............................................................G.
.G............................................................G.
.G............................................................G.
.G............................................................G.
GGGGGGGGGGGGGGGGGGGGGGGGGGGGGGGGGGGGGGGGGGGGGGGG.....GGGGGGGGGGG
.G............................................................G.
.G............................................................G.
.G............................................................G.
.G............................................................G.
GGGGGGGGGGGG.....GGGGGGGGGGGGGGGGGGGGGGGGGGGGGGGGGGGGGGGGGGGGGGG
.G..............................................................
.G..............................................................
.G..............................................................
.G..............................................................
GGGGGGGGGGGGGGGGGGGGGGGGGGGGGGGGGGGGGGGGGGGGGGGGGGGGGGGGGG......
GGGGGGGGGGGGGGGGGGGGGGGGGGGGGGGGGGGGGGGGGGGGGGGGGGGGGGGGGG......
GGGGGGGGGGGGGGGGGGGGGGGGGGGGGGGGGGGGGGGGGGGGGGGGGGGGGGGGGG......
................................................................
................................................................
................................................................
...................................................GGGGGGG......
...x...GGGG..............GGGGGG...................GGGGGGGGG.....
GGGGGGGGGGGGGGGGGGGGGGGGGGGGGGGGGGG...............GGGGGGGGG.....
.G...G.GGGG..G...G...G...GGGGGG..G.................GGGGGGG......
.G...G...G...G..GGGGGG...GGGGGG..G..............................
.G...G...G...G..GGGGGG...GGGGGG..G..............................
GGGGGGGGGGGGGGGGGGGGGGGGGGGGGGGGGGG.............................
.........................GGGGGG.................................
................................................................
.....................................G...G...G...G...G..........
.....................................G...G...G...G...G..........
..................GGGGGGGGG..........G...G...G...G...G..........
.................GGGGGGGGGGG.........GGGGGGGGGGGGGGGGG..........
.................GGGGGGGGGGG.........GGGGGGGGGGGGGGGGG..........
..GGGGGGGGGGG.....GGGGGGGGG..........GGGGGGGGGGGGGGGGG..........
..GGGGGGGGGGG........................G...G...G...G...G..........
..GGGGGGGGGGG...................................................
................................................................
................................................................
............GGGGGGGGGGGGGGGGGGGGGGGGGGGGGGGG....................
............GGGGGGGGG..............GGGGGGGGG....................
............GGGGGGGGG..............GGGGGGGGG...........GGGGGGG..
.......................................................GGGGGGG..
................................................................
............................x...................................
GGGGGGGGGGGGGGGGGGGGGGGGGGGGGGGGGGGGGGGGGGGGGGGGGGGGGG.....GGGGG
.G..G...G...G...G...G...G...G...G...G...G...G...G...G.......G...
.G..G...G...G...G...G...G...G...G...G...G...G...G...G.......G...
.G..G...G...G...G...G...G...G...G...G...G...G...G...G.......G...
GGGGGGGGGGGGGGGGGGGGGGGGGGGGGGGGGGGGGGGGGGGGGGGGGGGGGG.....GGGGG
................................................................
................................................................
................................................................
...........................................GGGGGGGGGGGGG........
...........................................GGGGGGGGGGGGG........
..........GGGGGGGGGGG......................GGGGGGGGGGGGG........
.........GGGGGGGGGGGGG..........................................
.........GGGGGGGGGGGGG..................G.......................
..........GGGGGGGGGGG...................G.....GGGGG.............
........................................G..x..GGGGG.............
......................................GGGGGGGGGGGGGGG...........
......................................GGGGGGGGGGGGGGG...........
GGGGGGGGGGGGGGGGGGGGGG_________GGGGGGGGGGGGGGGGGGGGGGGGGGGGGGGGG
GGGGGGGGGGGGGGGGGGGGGG.........GGGGGGGGGGGGGGGGGGGGGGGGGGGGGGGGG
GGGGGGGGGGGGGGGGGGGGGG.........GGGGGGGGGGGGGGGGGGGGGGGGGGGGGGGGG
GGGGGGGGGGGGGGGGGGGGGG.........GGGGGGGGGGGGGGGGGGGGGGGGGGGGGGGGG
GG..........GGGGGGGGGG...........GGGGGGGGGGGGGGGGGGGGGGGGGGGGGGG
GG..........GGGGGGGGGG..........................GGGGGGGGGGGGGGGG
GG..........GGGGGGGGGG..........................GGGGGGGGGGGGGGGG
GG..........GGGGGGGGGG..........................GGGGGGGGGGGGGGGG
GG..........GGGGGGGGGG..........................GGGGGGGGGGGGGGGG
GGGGGGGGGGGGGGGGGGGGGGGG........................GGGGGGGGGGGGGGGG
GGGGGGGGGGGGGGGGGGGGGGGGGGGGGGGGGGGGGGGGGGGGGGGGGGGGGGGGGGGGGGGG
GGGGGGGGGGGGGGGGGGGGGGGGGGGGGGGGGGGGGGGGGGGGGGGGGGGGGGGGGGGGGGGG
GGGGGGGGGGGGGGGGGGGGG...............................GGGGGGGGGGGG
GGGGGGGGGGGGGGGGGGGGG...............................GGGGGGGGGGGG
GGGGGGGGGGGGGGGGGGGGG...............................GGGGGGGGGGGG
GGGGGGGGGGGGGGGGGGGGG...............................GGGGGGGGGGGG
GGGGGGGGGGGGGGGGGGGGGGGGGGGGGGGGGGGGGGGGGGGGG.......GGGGGGGGGGGG
GGGGGGGGGGGGGGGGGGGGGGGGGGGGGGGGGGGGGGGGGGGGG.......GGGGGGGGGGGG
GGGGG.......GGGGGGGGGGGGGGGGGGGGGGGGGGGGGGGGG.......GGGGGGGGGGGG
GGGGG..........GGGGGGGGGGGGGGGGGGGGGGGGGGGGGG.................GG
GGGGG..........GGGGGGGGGGGGGGGGGGGGGGGGGGGGGG.................GG
GGGGG..........GGGGGGGGGGGGGGGGGGGGGGGGGGGGGG.................GG
GGGGG.......GGGGGGGGGGGGGGGGGGGGGGGGGGGGGGGGG.......GGGGG.....GG
GGGGG.......GGGGGGGGGGGGGGGGGGGGGGGGGGGGGGGGG.......GGGGG.....GG
GGGGG.........GGGGGGGGGGGGGGGGGGGGGGGGGGGGG.........GGGGG.....GG
GGGGG.................................GGG...........GGGGG.....GG
GGGGG.................................GGG...........GGGGG..t..GG
GGGGG...............................................GGGGGGGGGGGG
GGGGGGG...........................................GGGGGGGGGGGGGG
GGGGGGGGGGGGGGGGGGGG...........GGGGGGGGGGGGGGGGGGGGGGGGGGGGGGGGG
GGGGGGGGGGGGGGGGGGGG...........GGGGGGGGGGGGGGGGGGGGGGGGGGGGGGGGG
GGGGGGGGGGGGGGGGGGGG...........GGGGGGGGGGGGGGGGGGGGGGGGGGGGGGGGG
................................................................
................................................................
................................................................
.........................................................x......
GGGGGGGGGGGGGGGGGGGGGGGGGGGGGGGGGGGGGGGGGGGGGGGGGGGGGGGGGGGGGGGG
..G..G..G..G..G..G..G..G..G..G..G..G..G..G..G..G..G..G..G..G..G.
..G..G..G..G..G..G..G..G..G..G..G..G..G..G..G..G..G..G..G..G..G.
..G..G..G..G..G..G..G..G..G..G..G..G..G..G..G..G..G..G..G..G..G.
..G..G..G..G..G..G..G..G..G..G..G..G..G..G..G..G..G..G..G..G..G.
GGGGGGGGGGGGGGGGGGGGGGGGGGGGGGGGGGGGGGGGGGGGGGGGGGGGGGGGGGGGGGGG
GGGGGGGGGGGGGGGGGGGGGGGGGGGGGGGGGGGGGGGGGGGGGGGGGGGGGGGGGGGGGGGG
GGGGGGGGGGGGGGGGGGGGGGGGGGGGGGGGGGGGGGGGGGGGGGGGGGGGGGGGGGGGGGGG
GGGGGGGGGGGGGGGGGGGGGGGGGGGGGGGGGGGGGGGGGGGGGGGGGGGGGGGGGGGGGGGG
GGGGGGGGGGGGGGGGGGGGGGGGGGGGGGGGGGGGGGGGGGGGGGGGGGGGGGGGGGGGGGGG
GGGGGGGGGGGGGGGGGGGGGGGGGGGGGGGGGGGGGGGGGGGGGGGGGGGGGGGGGGGGGGGG
..G..G..G..G..G..G..G..G..G...................GGGGGGGGGGGGGGGGGG
..G..G..G..G..G..G..G..G..G...................GGGGGGGGGGGGGGGGGG
..G..G..G..G..G..G..G..G..G...................GGGGGGGGGGGGGGGGGG
GGGGGGGGGGGGGGGGGGGGGGGGGGG.......GGGGGGGGGGGGGGGGGGGGGGGGGGGGGG
GGGGGGGGGGGGGGGGGGGGGGGGGGG.......GGGGGGGGGGGGGGGGGGGGGGGGGGGGGG
..........................G.......G.............................
.....G............GGGGG...G_______G...G.........................
..GGGGGG..........GGGGG...G.......G...G.........................
..GGGGGG..................G.......G...G.........................
..........................G.......G.GGGGGGGGGGGGGGGG............
.................G....G...G.......G...GGGGGGGGGGGGGG............
............G....G....G...G.......G.............................
............G....G....G...G__.....G.............................
..........GGGGGGGGGGGGG...G.......G...GGGGGGGGGGGGGGGG..........
..........GGGGGGGGGGGGGGGGG.......GGGGGGGGGGGGGGGGGGGG..........
..........................G.......G.............................
..GGGGGG..............G...G.......G.............................
..GGGGGG..............G...G.......G.G...........................
......................G...G.....__G.G...........................
GGGGGGGGGGGGGGGGGGGGGGGGGGG.......GGGGGGGGGGGGGGGGGGGGGGGGGGGGGG
GGGGGGGGGGGGGGGGGGGGGGGGGGG...x...GGGGGGGGGGGGGGGGGGGGGGGGGGGGGG
.GG...G....................................GGG...G.G...G.....GG.
.GG...G....................................GGG...G.G...G.....GG.
.GG...G.....GGGGGGG.......GGGGGGGGG......GGGGGGG.G.....G.....GG.
.GG.........GGGGGGG.......GGGGGGGGG......GGGGGGG.G...........GG.
.GG..........................................................GG.
.GG.......................................................t..GG.
GGGGGGGGGGGGGGGGGGGGGGGGGGGGGGGGGGGGGGGGGGGGGGGGGGGGGGGGGGGGGGGG
GGGGGGGGGGGGGGGGGGGGGGGGGGGGGGGGGGGGGGGGGGGGGGGGGGGGGGGGGGGGGGGG
GGGGGGGGGGGGGGGGGGGGGGGGGGGGGGGGGGGGGGGGGGGGGGGGGGGGGGGGGGGGGGGG
............GGG..................................GGG............
............GGG..................................GGG............
............GGG.....GGGGGG............GGGGGG.....GGG............
............GGG....GGGGGGGG..........GGGGGGGG....GGG............
............GGG.....G....G............G....G.....GGG............
..........t.GGG..................................GGG.d..........
GGGGGGGGGGGGGGG..................................GGGGGGGGGGGGGGG
GGGGGGGGGGGGGGG..........G............G..........GGGGGGGGGGGGGGG
GGGGGGGGGGGGGGG..........G............G..........GGGGGGGGGGGGGGG
GGGGGGG................GGGGGGGGGGGGGGGGGG....................GGG
GGGGG....................GGGGGGGGGGGGGG.......................GG
GGG.....................................................B......G
GG...................................................GGGGGGG....
G........................GGGGGGGGGGGGG...............GGGGGGG....
.............GGGGGGGGGGGGGGGGGGGGGGGGGGGGGGGG........GGGGGGG....
.............GGGGGGGGGGGGGGGGGGGGGGGGGGGGGGGG...................
...........GGGGGGGGGGGGGGGGGGGGGGGGGGGGGGGGGGGG.................
.............GGGGGGGGGGGGGGGGGGGGGGGGGGGGGGGG...................
...............G....G......G..........G.....G...................
...............G....G......G..........G.....G...................
.._____........G....G.................G.....G.........______....
....................G.......................G...................
....................G.......................G...................
............................................G...................
..................................GGGGGG........................
.........G.......................GGGGGGGG..........__...........
.........G...G....................GGGGGG........................
.........G...G.........G..........G....G........................
.......GGGGGGGGGG.....GGGGGGG.............................#.....
.......GGGGGGGGGG.....GGGGGGG.......................GGGGGGGGGGG.
....................................................GGGGGGGGGGG.
................................................................
................................................................
GGGGGGGG____GGGGGGGGGGGGGGGGGGGGGGGGGGGGGGGGGGGGGGGGGGGGGGGGGGGG
GGGGGGGG....GGGGGGGGGGGGGGGGGGGGGGGGGGGGGGGGGGGGGGGGGGGGGGGGGGGG
.................................................GGGGGGGGGGGGGGG
.................................................GGGGGGGGGGGGGGG
.................................................GGGGGGGGGGGGGGG
......................................_____...........GGGGGGGGGG
GGGGGGGG................................................GGGGGGGG
GGGGGGGG................................................GGGGGGGG
............................GGGG.................G.........GGGGG
............GGGGGG.........GGGGGG.............B..G.........GGGGG
..........GGGGGGGGGG.......GGGGGG............GGGGGGGGG.......GGG
.........GGGGGGGGGGGG.......GGGG.............GGGGGGGGG........GG
.........GGGGGGGGGGGG.........................G.....G..........G
..........GGGGGGGGGG................#.........G.....G...........
............GGGGGG................GGGGGG........................
GG................................GGGGGG........................
GGG................................................G............
GGGG..........................................G....G............
GGGGGG.............#...........#..............G....G............
GGGGGGGGGGGGGGGGGGGGGGGGGGGGGGGGGGGGGGGGGGGGGGGGGGGGGGGGGG______
GGGGGGGGGGGGGGGGGGGGGGGGGGGGGGGGGGGGGGGGGGGGGGGGGGGGGGGGGG......
GGGGGGGGGGGGGGGGGGGGGGGGGGGGGGGGGGGGGGGGGGGGGGGGGGGGGGGGGG......
................................................................
................................................................
...............G..G......................................GGGGGGG
...............G..G......................................GGGGGGG
.............GGGGGGGG................................#...GGGGGGG
.............GGGGGGGG...............................GGGGGGGGGGGG
......#......................G......................GGGGGGGGGGGG
....GGGGG.................G..G..G........................GGGGGGG
....GGGGG.................GGGGGGG.........x..............GGGGGGG
............G..x..G.......G..G..G.....G...G...G..........GGGGGGG
............GGGGGGG.......GGGGGGG.....G...G...G..........GGGGGGG
............G..G..G.......G..G..G.....G...G...G.......B..GGGGGGG
GGGGGGGGGGGGGGGGGGGGGGGGGGGGGGGGGGGGGGGGGGGGGGGGGGGGGGGGGGGGGGGG
GGGGGGGGGGGGGGGGGGGGGGGGGGGGGGGGGGGGGGGGGGGGGGGGGGGGGGGGGGGGGGGG
GGGGGGGGGGGGGGGGGGGGGGGGGGGGGGGGGGGGGGGGGGGGGGGGGGGGGGGGGGGGGGGG