w192
h64
x77
y29
.......GGG................GGG..............GGGGGGGGGGGGGGG..................GGG.............................................GGGGGGGGGGGGGGGGGGGGG...............................................
.......GGG................GGG..............GGGGGGGGGGGGGGG..................GGG.x...........................................GGGGGGGGGGGGGGGGGGGGG...............................................
.......GGG................GGG..............GGGGGGGGGGGGGGG..................GGGGGGGGGG......................................GGGGGGGGGGGGGGGGGGGGG...............................................
.......GGG................GGGGGGGGGGGGGG...GGGGGGGGGGGGGGG..................GGG.................................................................................................................
.......GGG................GGGGGGGGGGGGGG...GGGGGGGGGGGGGGG..................GGG............................................................................................GGGGGGGG.............
.......GGG.................................GGGGGGGGGGGGGGG..................GGG............................................................................................GGGGGGGG.............
.......GGG.................................GGGGGGGGGGGGGGG......................................GGGGGGGG.....GGGGGGG........GGG...GGG...GGG...GGG...............................................
.......GGG.......GGGGGGGGGGGGGGGGGGGGGGGGGGGGGGGGGGGGGGGGG......................................GGGGGGGG.....GGGGGGG........GGG...GGG...GGG...GGG......GGGGGGGG.................................
.................GGGGGGGGGGGGGGGGGGGGGGGGGGGGGGGGGGGGGGGGG...................................................GGGGGGG........GGG...GGG...GGG...GGG......GGGGGGGG.................GGGG............
.................GGGGGG....................GGGGGGGGGGGGGGG..................GGGGGGGGGGGGGGG..........x.......GGGGGGG........GGG...GGG...GGG...GGG.................GGGGGGGG......GGGG............
.......GGG.................................GGGGGGGGGGGGGGG..................GGGGGGGGGGGGGGG..........G.......GGGGGGG........GGG.G.GGG.G.GGG.G.GGG.................GGGGGGGG......GGGG............
.......GGG..........................x......GGGGGGGGGGGGGGG..................GGGGGGGGGGGGGGG..........G.......GGGGGGG........GGG.G.GGG.G.GGG.G.GGG...............................GGGG.....x......
.......GGG.................................GGGGGGGGGGGGGGG..................GGGGGGGGGGGGGGG..........G.......GGGGGGG........GGG.G.GGG.G.GGG.G.GGG...............................GGGG............
GGGGGGGGGGGGGGGGGGGGGGGGGGGGGGGGGGGGGGGGGGGGGGGGGGGGGGGGGGGGGGGGGGGGGGGGGGGGGGGGGGGGGGGGGGGGGGGGGGGGGGGGGGGGGGGGGGGGGGGGGGGGGGGGGGGGGGGGGGGGGGGGGGGGGGGGGGGGGGGGGGGGGGGGGGGGGGGGGGGGGGGGGGGGGGGG
GGGGGGGGGGGGGGGGGGGGGGGGGGGGGGGGGGGGGGGGGGGGGGGGGGGGGGGGGGGGGGGGGGGGGGGGGGGGGGGGGGGGGGGGGGGGGGGGGGGGGGGGGGGGGGGGGGGGGGGGGGGGGGGGGGGGGGGGGGGGGGGGGGGGGGGGGGGGGGGGGGGGGGGGGGGGGGGGGGGGGGGGGGGGGGGG
GGGGGGGGGGGGGGGGGGGGGGGGGGGGGGGGGGGGGGGGGGGGGGGGGGGGGGGGGGGGGGGGGGGGGGGGGGGGGGGGGGGGGGGGGGGGGGGGGGGGGGGGGGGGGGGGGGGGGGGGGGGGGGGGGGGGGGGGGGGGGGGGGGGGGGGGGGGGGGGGGGGGGGGGGGGGGGGGGGGGGGGGGGGGGGGG
GG.........................................GGGGGGGGGGGGGGG...............................G.....G.....G.....G..........GGGGG..................................GGG................................
GG.........................................GGGGGGGGGGGGGGG.d.............................G.....G.....G.....G..........GGGGG.s................................GGG..........................x.....
GG.........................................GGGGGGGGGGGGGGGGGGGGGG.....................................................GGGGGGGGGGGG...........................GGG................................
GGGGGGGGGGGGGGGGGGGGGGGGGGGGGGGGGGGGGG.....GGGGGGGGGGGGGGGGGGGGGGG.............................................GGGGGGGGGGGG.........................GG.......GGGGGGGGGGGGGG..........GGGGGGGGGGG
GGGGGGGGGGGGGGGGGGGGGGGGGGGGGGGGG..........GGGGGGGGGGGGGGG............................................................GGGGG.........................GG.......GGGGGGGGGGGGGG..........GGGGGGGGGGG
GGGGGGGGGGGGGGGGGGGGGGGGGGGGGGG.........GGGGGGGGGGGGGGGGGG...................GGGGGGGGGGGGGGGGGGGGGGGGGGGGGGGG.........GGGGGGGGGG....................GGGGGGGGGGGG........GGG..........GGG........
GGG...................................GGGGGGGGGGGGGGGGGGGG...................GGGGGGGGGGGGGGGGGGGGGGGGGGGGGGGG.........GGGGG.........................GGGGGGGGGGGG........GGG..........GGG........
GGG................................GGGGGGGGGGGGGGGGGGGGGGG...................GGGGGGGGGGGGGGGGGGGGGGGGGGGGGGGG.........GGGGG..................................GGG........GGG..........GGG........
GGG..x...........................GGGGGGGGGGGGGGGGGGGGGGGGG...................GGGGGGGGGGGGGGG.............GGGG.........GGGGG.x................................GGG........GGG..........GGG........
GGGGGGGGGGGGGGGGG....GGGGGGGGGGGGGGGGGGGGGGGGGGGGGGGGGGGGG...................GGGGGGGGGGGGGGG.............GGGG.........GGGGGGGGGGGGGGGGGGGGGGGGGGGGGGGGGG.....GGG........GGG..........GGG........
GGGGGGGGGGGGGGGGG....GGGGGGGGGGGGGGGGGGGGGGGGGGGGGGGGGGGGG.....................G..G..G..G..G.............GGGG.........GGGGGGGGGGGGGGGGGGGGGGGGGGGGGGGGGG.....GGG........GGG..........GGG........
GGG...................................GGGGGGGGGGGGGGGGGGGG...............................................GGGG.........GGGGG..................................GGG........GGG..........GGG........
GGG...................................GGGGGGGGGGGGGGGGGGGG.............GGGGG.............................GGGG.........GGGGG..................................GGG........GGG..........GGG........
GGGGGGGGGGGGGGGGGGGGGGGGGGGGGGGGG.....GGGGGGGGGGGGGGGGGGGG.............GGGGG.......................w.....GGGG.........GGGGG..................................GGG........GGG..........GGG........
...........................................GGGGGGGGGGGGGGG.............GGGGGGGGGGGGGGGGGGGGGGGGGGGGGGGGGGGGGG.........GGGGG.....GGGGGGGGGGGGGGGGGGGGGGGGGGGGGGGG........GGG..........GGG........
...........................................GGGGGGGGGGGGGGG.............GGGGGGGGGGGGGGGGGGGGGGGGGGGGGGGGGGGGGG.........GGGGG.....GGGGGGGGGGGGGGGGGGGGGGGGGGGGGGGG........GGG..........GGG........
..............G...G........................GGGGGGGGGGGGGGG.............GGGGGGGGGGGGGGGGGGGGGGGGGGGGGGGGGGGGGG.........GGGGG..................................GGG........GGG..........GGG........
..............G.x.G........................GGGGGGGGGGGGGGG............................................................GGGGG..................................GGG........GGG..........GGG........
............GGGGGGGGG.................................................................................................GGGGG..................................GGG........GGG..........GGG........
............GGGGGGGGG.................................................................................................GGGGGGGGGGGGGGGGGGGGGGGGGGGGGGGGGG.....GGG........GGG..........GGG........
..............GGGGG...............................................G...........................GGGGGGGGGG..............GGGGGGGGGGGGGGGGGGGGGGGGGGGGGGGGGG.....GGG........GGG..........GGG........
...............GGG................................................G...........................GGGGGGGGGG..............GGGGG..................................GGG........GGG..........GGG........
...............GGG................................................G...........................GGGGGGGGGG..............GGGGG..................................GGG........GGG..........GGG........
.......GGGG...........GGGG........................................G...........................GGGGGGGGGG..............GGGGG..................................GGG........GGG..........GGG........
.......GGGG...........GGGG................................GGGGGGGGGGGGGGGG............................................GGGGG.....GGGGGGGGGGGGGGGGGGGGGGGGGGGGGGGG........GGG..........GGG........
....GGGGGGG.....x.....GGGGGGG.............................GGGGGGGGGGGGGGGG..............G.............................GGGGG.....GGGGGGGGGGGGGGGGGGGGGGGGGGGGGGGG........GGG..........GGG........
....GGGGGGG...........GGGGGGG.............................GGGGGGGGGGGGGGGG..............G.......................................GG...........................GGG........GGG..........GGG........
....GGGGGGG...........GGGGGGG.............................GGGGGGGGGGGGGGGG..............G.......................................GG...........................GGG........GGG..........GGG........
....GGGGGGG...........GGGGGGG.......................................................GGGGGGGGGGGGGGGGGG..........................GG...........................GGG........GGG..........GGG........
GGGGGGGGGGGGGGGGGGGGGGGGGGGGGGGGGGGGGGGGGGGG........................................GGGGGGGGGGGGGGGGGG.............................G..G..G...................GGG........GGG..........GGG........
GGGGGGGGGGGGGGGGGGGGGGGGGGGGGGGGGGGGGGGGGGGG........................................GGGGGGGGGGGGGGGGGG.......................................................GGGGGGGGGGGGGG..........GGGGGGGGGGG
GGGGGGGGGGGGGGGGGGGGGGGGGGGGGGGGGGGGGGGGGGGG.................................................................................................................GGGGGGGGGGGGGG..........GGGGGGGGGGG
GGGGGGGGGGGGGGGGGGGGGGGGGGGGGGGGGGGGGGGGGGGG..........................................................................GGGGGGGGGGGGGGGGGGGGG..................GGG................................
...........GGGGGGGGGGGGGGGGGGGGGGGGG.....GGG..................G.......................................................GGGGGGGGGGGGGGGGGGGGG..................GGG................................
...........GGGGGGGGGGGGGGGGGGGGGGGGG.....GGG...............GGGGGGGGGG.................................................GGGGGGGGGGGGGGGGGGGGG..................GGG................................
...........GGGGGGGGGGGGGGGGGGGGGGGGG.....GGG...............GGGGGGGGGG.................................................GGGGGGGGGGGGGGGGGGGGG..................GGGGGGGGGGGGGGGGGGGGGGGGGGGGGGGGGGG
...........GG...GGG...GGG...GGG...GG.....GGG..........................................................................GGGGGGGGGGGGGGGGGGGGG..................GGGGGGGGGGGGGGGGGGGGGGGGGGGGGGGGGGG
.........................................GGG......................................................................GGGGGGGGGGGGGGGGGGGGGGGGG..................GGGGGGGGGGGGGGGGGGGGGGGGGGGGGGGGGGG
.........................................GGG......................................................................GGGGGGGGGGGGGGGGGGGGGGGGG..................GGGGGGGGGGGGGGGGGGGGGGGGGGGGGGGGGGG
.........................................GGG............................................GGGGGGGGGGGGG.................GGGGGGGGGGGGGGGGGGGGG..................GGGGGGGGGGGGGGGGGGGGGGGGGGGGGGGGGGG
...........GGGGG...GGG...GGG...GGGGG.....GGGGGGGGGGG....................................GGGGGGGGGGGGG.................GGGGGGGGGGGGGGGGGGGGG..................GGG................................
...........GGGGGGGGGGGGGGGGGGGGGGGGG.....GGGGGGGGGGG..................................................................GGGGGGGGGGGGGGGGGGGGG..................GGG................................
...........GGGGGGGGGGGGGGGGGGGGGGGGG.....GGG..........................................................................GGGGGGGGGGGGGGGGGGGGG..................GGGGGG...GG....GG....G...GG........
.......x...GGGGGGGGGGGGGGGGGGGGGGGGG.....GGG..........................................................................GGGGGGGGGGGGGGGGGGGGG..................GGG......................GG..x.....
...........GGGGGGGGGGGGGGGGGGGGGGGGG.....GGG..................................................t.......................GGGGGGGGGGGGGGGGGGGGG..................GGG......................GG........
GGGGGGGGGGGGGGGGGGGGGGGGGGGGGGGGGGGGGGGGGGGGGGGGGGGGGGGGGGGGGGGG.......................GGGGGGGGGGGGGGG................GGGGGGGGGGGGGGGGGGGGG..................GGGGGGGGGGGGGGGGGGGGGGGGGGGGGGGGGGG
GGGGGGGGGGGGGGGGGGGGGGGGGGGGGGGGGGGGGGGGGGGGGGGGGGGGGGGGGGGGGGGG.......................GGGGGGGGGGGGGGG................GGGGGGGGGGGGGGGGGGGGG..................GGGGGGGGGGGGGGGGGGGGGGGGGGGGGGGGGGG
GGGGGGGGGGGGGGGGGGGGGGGGGGGGGGGGGGGGGGGGGGGGGGGGGGGGGGGGGGGGGGGG.......................GGGGGGGGGGGGGGG................GGGGGGGGGGGGGGGGGGGGG.....GGGGGGGG.....GGGGGGGGGGGGGGGGGGGGGGGGGGGGGGGGGGG