w192
h64
x77
y29
.......GGG................GGG..............GGGGGGGGGGGGGGG..................GGG.............................................GGGGGGGGGGGGGGGGGGGGG...............................................
.......GGG................GGG..............GGGGGGGGGGGGGGG..................GGG.x...........................................GGGGGGGGGGGGGGGGGGGGG...............................................
.......GGG................GGG..............GGGGGGGGGGGGGGG..................GGGGGGGGGG......................................GGGGGGGGGGGGGGGGGGGGG...............................................
.......GGG................GGGGGGGGGGGGGG...GGGGGGGGGGGGGGG..................GGG.......................G.........................................................................................
.......GGG................GGGGGGGGGGGGGG...GGGGGGGGGGGGGGG..................GGG..................G....G...........G........................................................GGGGGGGGGG...........
.......GGG.................................GGGGGGGGGGGGGGG..................GGG..................G....G...........G.......................................G................GGGGGGGGGG...........
.......GGG.................................GGGGGGGGGGGGGGG......................................GGGGGGGG.....GGGGGGG........GGG...GGG...GGG...GGG.........G.....................................
.......GGG.......GGGGGGGGGGGGGGGGGGGGGGGGGGGGGGGGGGGGGGGGG............................G.........GGGGGGGG.....GGGGGGG........GGG...GGG...GGG...GGG......GGGGGGGG.................................
.................GGGGGGGGGGGGGGGGGGGGGGGGGGGGGGGGGGGGGGGGG............................G......................GGGGGGG........GGG...GGG...GGG...GGG......GGGGGGGG.................GGGG............
.................GGGGGG....................GGGGGGGGGGGGGGG..................GGGGGGGGGGGGGGG..........x.......GGGGGGG........GGG...GGG...GGG...GGG.................GGGGGGGG......GGGG............
.......GGG.................................GGGGGGGGGGGGGGG..................GGGGGGGGGGGGGGG..........G.......GGGGGGG........GGG.G.GGG.G.GGG.G.GGG.................GGGGGGGG......GGGG............
.......GGG..........................x......GGGGGGGGGGGGGGG..................GGGGGGGGGGGGGGG..........G.......GGGGGGG........GGG.G.GGG.G.GGG.G.GGG...............................GGGG.....x......
.......GGG.................................GGGGGGGGGGGGGGG..................GGGGGGGGGGGGGGG..........G.......GGGGGGG........GGG.G.GGG.G.GGG.G.GGG...............................GGGG............
GGGGGGGGGGGGGGGGGGGGGGGGGGGGGGGGGGGGGGGGGGGGGGGGGGGGGGGGGGGGGGGGGGGGGGGGGGGGGGGGGGGGGGGGGGGGGGGGGGGGGGGGGGGGGGGGGGGGGGGGGGGGGGGGGGGGGGGGGGGGGGGGGGGGGGGGGGGGGGGGGGGGGGGGGGGGGGGGGGGGGGGGGGGGGGGG
GGGGGGGGGGGGGGGGGGGGGGGGGGGGGGGGGGGGGGGGGGGGGGGGGGGGGGGGGGGGGGGGGGGGGGGGGGGGGGGGGGGGGGGGGGGGGGGGGGGGGGGGGGGGGGGGGGGGGGGGGGGGGGGGGGGGGGGGGGGGGGGGGGGGGGGGGGGGGGGGGGGGGGGGGGGGGGGGGGGGGGGGGGGGGGGG
GGGGGGGGGGGGGGGGGGGGGGGGGGGGGGGGGGGGGGGGGGGGGGGGGGGGGGGGGGGGGGGGGGGGGGGGGGGGGGGGGGGGGGGGGGGGGGGGGGGGGGGGGGGGGGGGGGGGGGGGGGGGGGGGGGGGGGGGGGGGGGGGGGGGGGGGGGGGGGGGGGGGGGGGGGGGGGGGGGGGGGGGGGGGGGGG
GG.........................................GGGGGGGGGGGGGGG............................................................GGGGG..................................GGG................................
GG.........................................GGGGGGGGGGGGGGG.d..........................................................GGGGG.s................................GGG...........................x....
GG.........................................GGGGGGGGGGGGGGGGGGGGGG..............................................GGGGGGGGGGGGGGGGGGG...........................GGG................................
GGGGGGGGGGGGGGGGGGGGGGGGGGGGGGGGGGGGGG.....GGGGGGGGGGGGGGGGGGGGGGG....................................................GGGGG.........................GG.......GGGGGGGGGGGGGG..........GGGGGGGGGGG
GGGGGGGGGGGGGGGGGGGGGGGGGGGGGGGGG..........GGGGGGGGGGGGGGG............................................................GGGGG.........................GG.......GGGGGGGGGGGGGG..........GGGGGGGGGGG
GGGGGGGGGGGGGGGGGGGGGGGGGGGGGGG............GGGGGGGGGGGGGGG...................GGGGGGGGGGGGGGGGGGGGGGGGGGGGGGGG.........GGGGGGGGGG....................GGGGGGGGGGGG........GGG..........GGG........
GGG........................................GGGGGGGGGGGGGGG...................GGGGGGGGGGGGGGGGGGGGGGGGGGGGGGGG.........GGGGG.........................GGGGGGGGGGGG........GGG..........GGG........
GGG................................GGGGGGGGGGGGGGGGGGGGGGG...................GGGGGGGGGGGGGGGGGGGGGGGGGGGGGGGG.........GGGGG..................................GGG........GGG..........GGG........
GGG..B...........................GGGGGGGGGGGGGGGGGGGGGGGGG...................GGGGGGGGGGGGGGG.............GGGG.........GGGGG.B................................GGG........GGG..........GGG........
GGGGGGGGGGGGGGGGG....GGGGGGGGGGGGGGGGGGGGGGGGGGGGGGGGGGGGG...................GGGGGGGGGGGGGGG.............GGGG.........GGGGGGGGGGGGGGGGGGGGGGGGGGGGGGGGGG.....GGG........GGG..........GGG........
GGGGGGGGGGGGGGGGG....GGGGGGGGGGGGGGGGGGGGGGGGGGGGGGGGGGGGG.....................G..G..G..G..G.............GGGG.........GGGGGGGGGGGGGGGGGGGGGGGGGGGGGGGGGG.....GGG........GGG..........GGG........
GGG...................................GGGGGGGGGGGGGGGGGGGG...............................................GGGG.........GGGGG..................................GGG........GGG..........GGG........
GGG...................................GGGGGGGGGGGGGGGGGGGG................GG.............................GGGG.........GGGGG..................................GGG........GGG..........GGG........
GGGGGGGGGGGGGGGGGGGGGGGGGGGGGGGGG.....GGGGGGGGGGGGGGGGGGGG................GG.......................w.....GGGG.........GGGGG..................................GGG........GGG..........GGG........
...........................................GGGGGGGGGGGGGGG................GGGGGGGGGGGGGGGGGGGGGGGGGGGGGGGGGGG.........GGGGG.....GGGGGGGGGGGGGGGGGGGGGGGGGGGGGGGG........GGG..........GGG........
...........................................GGGGGGGGGGGGGGG................GGGGGGGGGGGGGGGGGGGGGGGGGGGGGGGGGGG.........GGGGG.....GGGGGGGGGGGGGGGGGGGGGGGGGGGGGGGG........GGG..........GGG........
..............G...G........................GGGGGGGGGGGGGGG................GGGGGGGGGGGGGGGGGGGGGGGGGGGGGGGGGGG.........GGGGG..................................GGG........GGG..........GGG........
..............G.x.G........................GGGGGGGGGGGGGGG............................................................GGGGG..................................GGG........GGG..........GGG........
............GGGGGGGGG.................................................................................................GGGGG..................................GGG........GGG..........GGG........
............GGGGGGGGG.................................................................................................GGGGGGGGGGGGGGGGGGGGGGGGGGGGGGGGGG.....GGG........GGG..........GGG........
..............GGGGG...............................................G...................................................GGGGGGGGGGGGGGGGGGGGGGGGGGGGGGGGGG.....GGG........GGG..........GGG........
...............GGG................................................G...................................................GGGGG..................................GGG........GGG..........GGG........
...............GGG................................................G...................................................GGGGG..................................GGG........GGG..........GGG........
.......GGGG...........GGGG........................................G...................................................GGGGG..................................GGG........GGG..........GGG........
.......GGGG...........GGGG................................GGGGGGGGGGGGGGGG............................................GGGGG.....GGGGGGGGGGGGGGGGGGGGGGGGGGGGGGGG........GGG..........GGG........
....GGGGGGG.....x.....GGGGGGG.............................GGGGGGGGGGGGGGGG..............G.............................GGGGG.....GGGGGGGGGGGGGGGGGGGGGGGGGGGGGGGG........GGG..........GGG........
....GGGGGGG...........GGGGGGG.............................GGGGGGGGGGGGGGGG..............G....................................................................GGG........GGG..........GGG........
....GGGGGGG...........GGGGGGG.............................GGGGGGGGGGGGGGGG..............G....................................................................GGG........GGG..........GGG........
....GGGGGGG...........GGGGGGG.......................................................GGGGGGGGGGGGGGGGGG.......................................................GGG........GGG..........GGG........
GGGGGGGGGGGGGGGGGGGGGGGGGGGGGGGGGGGGGGGGGGGG........................................GGGGGGGGGGGGGGGGGG.......................................................GGG........GGG..........GGG........
GGGGGGGGGGGGGGGGGGGGGGGGGGGGGGGGGGGGGGGGGGGG........................................GGGGGGGGGGGGGGGGGG.......................................................GGGGGGGGGGGGGG..........GGGGGGGGGGG
GGGGGGGGGGGGGGGGGGGGGGGGGGGGGGGGGGGGGGGGGGGG.................................................................................................................GGGGGGGGGGGGGG..........GGGGGGGGGGG
GGGGGGGGGGGGGGGGGGGGGGGGGGGGGGGGGGGGGGGGGGGG..........................................................................GGGGGGGGGGGGGGGGGGGGG..................GGG................................
...........GGGGGGGGGGGGGGGGGGGGGGGGG.....GGG..................G.......................................................GGGGGGGGGGGGGGGGGGGGG..................GGG................................
...........GGGGGGGGGGGGGGGGGGGGGGGGG.....GGG...............GGGGGGGGGG.................................................GGGGGGGGGGGGGGGGGGGGG..................GGG................................
...........GGGGGGGGGGGGGGGGGGGGGGGGG.....GGG...............GGGGGGGGGG.................................................GGGGGGGGGGGGGGGGGGGGG..................GGGGGGGGGGGGGGGGGGGGGGGGGGGGGGGGGGG
...........GG...GGG...GGG...GGG...GG.....GGG..........................................................................GGGGGGGGGGGGGGGGGGGGG..................GGGGGGGGGGGGGGGGGGGGGGGGGGGGGGGGGGG
.........................................GGG......................................................................GGGGGGGGGGGGGGGGGGGGGGGGG..................GGGGGGGGGGGGGGGGGGGGGGGGGGGGGGGGGGG
.........................................GGG......................................................................GGGGGGGGGGGGGGGGGGGGGGGGG..................GGGGGGGGGGGGGGGGGGGGGGGGGGGGGGGGGGG
.........................................GGG............................................GGGGGGGGGGGGG.................GGGGGGGGGGGGGGGGGGGGG..................GGGGGGGGGGGGGGGGGGGGGGGGGGGGGGGGGGG
...........GGGGG...GGG...GGG...GGGGG.....GGGGGGGGGGG....................................GGGGGGGGGGGGG.................GGGGGGGGGGGGGGGGGGGGG..................GGG................................
...........GGGGGGGGGGGGGGGGGGGGGGGGG.....GGGGGGGGGGG..................................................................GGGGGGGGGGGGGGGGGGGGG..................GGG................................
...........GGGGGGGGGGGGGGGGGGGGGGGGG.....GGG..........................................................................GGGGGGGGGGGGGGGGGGGGG..................GGGGGG...GG....GG....G...GG........
.......x...GGGGGGGGGGGGGGGGGGGGGGGGG.....GGG..........................................................................GGGGGGGGGGGGGGGGGGGGG..................GGG......................GG..x.....
...........GGGGGGGGGGGGGGGGGGGGGGGGG.....GGG..................................................t.......................GGGGGGGGGGGGGGGGGGGGG..................GGG......................GG........
GGGGGGGGGGGGGGGGGGGGGGGGGGGGGGGGGGGGGGGGGGGGGGGGGGGGGGGGGGGGGGGG.......................GGGGGGGGGGGGGGG................GGGGGGGGGGGGGGGGGGGGG..................GGGGGGGGGGGGGGGGGGGGGGGGGGGGGGGGGGG
GGGGGGGGGGGGGGGGGGGGGGGGGGGGGGGGGGGGGGGGGGGGGGGGGGGGGGGGGGGGGGGG.......................GGGGGGGGGGGGGGG................GGGGGGGGGGGGGGGGGGGGG..................GGGGGGGGGGGGGGGGGGGGGGGGGGGGGGGGGGG
GGGGGGGGGGGGGGGGGGGGGGGGGGGGGGGGGGGGGGGGGGGGGGGGGGGGGGGGGGGGGGGG.......................GGGGGGGGGGGGGGG................GGGGGGGGGGGGGGGGGGGGG.....GGGGGGGG.....GGGGGGGGGGGGGGGGGGGGGGGGGGGGGGGGGGG