w192
h64
x77
y29
.......GGG................GGG..............GGGGGGGGGGGGGGG..................GGG.............................................GGGGGGGGGGGGGGGGGGGGG........................................GGGGGGG
.......GGG................GGG..............GGGGGGGGGGGGGGG..................GGG.x...........................................GGGGGGGGGGGGGGGGGGGGG........................................GGGGGGG
.......GGG................GGG..............GGGGGGGGGGGGGGG..................GGGGGGGGGG......................................GGGGGGGGGGGGGGGGGGGGG........................................GGGGGGG
.......GGG................GGGGGGGGGGGGGG...GGGGGGGGGGGGGGG..................GGG..........................................................................................................GGGGGGG
.......GGG................GGGGGGGGGGGGGG...GGGGGGGGGGGGGGG..................GGG............................................................................................GGGGGGGG......GGGGGGG
.......GGG.................................GGGGGGGGGGGGGGG..................GGG............................................................................................GGGGGGGG......GGGGGGG
.......GGG.................................GGGGGGGGGGGGGGG......................................GGGGGGGG.....GGGGGGG........GGG...GGG...GGG...GGG........................................GGGGGGG
.......GGG.......GGGGGGGGGGGGGGGGGGGGGGGGGGGGGGGGGGGGGGGGG......................................GGGGGGGG.....GGGGGGG........GGG...GGG...GGG...GGG......GGGGGGGG..........................GGGGGGG
.................GGGGGGGGGGGGGGGGGGGGGGGGGGGGGGGGGGGGGGGGG...................................................GGGGGGG........GGG...GGG...GGG...GGG......GGGGGGGG.................GGGG.....GGGGGGG
.................GGGGGG.............G......GGGGGGGGGGGGGGG..................GGGGGGGGGGGGGGG..........x.......GGGGGGG........GGG...GGG...GGG...GGG.................GGGGGGGG......GGGG.....GGGGGGG
.......GGG..........................G......GGGGGGGGGGGGGGG..................GGGGGGGGGGGGGGG..........G.......GGGGGGG........GGG.G.GGG.G.GGG.G.GGG.................GGGGGGGG......GGGG.....G......
.......GGG..........................G......GGGGGGGGGGGGGGG..................GGGGGGGGGGGGGGG..........G.......GGGGGGG........GGG.G.GGG.G.GGG.G.GGG...............................GGGG.....G......
.......GGG.................................GGGGGGGGGGGGGGG..................GGGGGGGGGGGGGGG..........G.......GGGGGGG........GGG.G.GGG.G.GGG.G.GGG...............................GGGG............
GGGGGGGGGGGGGGGGGGGGGGGGGGGGGGGGGGGGGGGGGGGGGGGGGGGGGGGGGGGGGGGGGGGGGGGGGGGGGGGGGGGGGGGGGGGGGGGGGGGGGGGGGGGGGGGGGGGGGGGGGGGGGGGGGGGGGGGGGGGGGGGGGGGGGGGGGGGGGGGGGGGGGGGGGGGGGGGGGGGGGGGGGGGGGGGG
GGGGGGGGGGGGGGGGGGGGGGGGGGGGGGGGGGGGGGGGGGGGGGGGGGGGGGGGGGGGGGGGGGGGGGGGGGGGGGGGGGGGGGGGGGGGGGGGGGGGGGGGGGGGGGGGGGGGGGGGGGGGGGGGGGGGGGGGGGGGGGGGGGGGGGGGGGGGGGGGGGGGGGGGGGGGGGGGGGGGGGGGGGGGGGGG
GGGGGGGGGGGGGGGGGGGGGGGGGGGGGGGGGGGGGGGGGGGGGGGGGGGGGGGGGGGGGGGGGGGGGGGGGGGGGGGGGGGGGGGGGGGGGGGGGGGGGGGGGGGGGGGGGGGGGGGGGGGGGGGGGGGGGGGGGGGGGGGGGGGGGGGGGGGGGGGGGGGGGGGGGGGGGGGGGGGGGGGGGGGGGGGG
GG.........................................GGGGGGGGGGGGGGG...............................G.....G.....G.....G..........GGGGG..................................GGG.........................G......
GG.........................................GGGGGGGGGGGGGGG.d.............................G.....G.....G.....G..........GGGGG.s................................GGG.........................G......
GG.........................................GGGGGGGGGGGGGGGGGGGGGG.....................................................GGGGGGGGGGGG...........................GGG................................
GGGGGGGGGGGGGGGGGGGGGGGGGGGGGGGGGGGGGG.....GGGGGGGGGGGGGGGGGGGGGGG.............................................GGGGGGGGGGGG.........................GG.......GGGGGGGGGGGGGG..........GGGGGGGGGGG
GGGGGGGGGGGGGGGGGGGGGGGGGGGGGGGGG..........GGGGGGGGGGGGGGG............................................................GGGGG.........................GG.......GGGGGGGGGGGGGG..........GGGGGGGGGGG
GGGGGGGGGGGGGGGGGGGGGGGGGGGGGGG.........GGGGGGGGGGGGGGGGGG...................GGGGGGGGGGGGGGGGGGGGGGGGGGGGGGGG.........GGGGGGGGGG....................GGGGGGGGGGGG........GGG..........GGG........
GGG...................................GGGGGGGGGGGGGGGGGGGG...................GGGGGGGGGGGGGGGGGGGGGGGGGGGGGGGG.........GGGGG.........................GGGGGGGGGGGG........GGG..........GGG........
GGG................................GGGGGGGGGGGGGGGGGGGGGGG...................GGGGGGGGGGGGGGGGGGGGGGGGGGGGGGGG.........GGGGG..................................GGG........GGG..........GGG........
GGG..x...........................GGGGGGGGGGGGGGGGGGGGGGGGG...................GGGGGGGGGGGGGGG.............GGGG.........GGGGG.x................................GGG........GGG..........GGG........
GGGGGGGGGGGGGGGGG....GGGGGGGGGGGGGGGGGGGGGGGGGGGGGGGGGGGGG...................GGGGGGGGGGGGGGG.............GGGG.........GGGGGGGGGGGGGGGGGGGGGGGGGGGGGGGGGG.....GGG........GGG..........GGG........
GGGGGGGGGGGGGGGGG....GGGGGGGGGGGGGGGGGGGGGGGGGGGGGGGGGGGGG.....................G..G..G..G..G.............GGGG.........GGGGGGGGGGGGGGGGGGGGGGGGGGGGGGGGGG.....GGG........GGG..........GGG........
GGG...................................GGGGGGGGGGGGGGGGGGGG...............................................GGGG.........GGGGG..................................GGG........GGG..........GGG........
GGG...................................GGGGGGGGGGGGGGGGGGGG.............GGGGG.............................GGGG.........GGGGG..................................GGG........GGG..........GGG........
GGGGGGGGGGGGGGGGGGGGGGGGGGGGGGGGG.....GGGGGGGGGGGGGGGGGGGG.............GGGGG.....t..t..t..t......t.w.....GGGG.........GGGGG..................................GGG........GGG..........GGG........
...........................................GGGGGGGGGGGGGGG.............GGGGGGGGGGGGGGGGGGGGGGGGGGGGGGGGGGGGGG.........GGGGG.....GGGGGGGGGGGGGGGGGGGGGGGGGGGGGGGG........GGG..........GGG........
...........................................GGGGGGGGGGGGGGG.............GGGGGGGGGGGGGGGGGGGGGGGGGGGGGGGGGGGGGG.........GGGGG.....GGGGGGGGGGGGGGGGGGGGGGGGGGGGGGGG........GGG..........GGG........
..............G...G........................GGGGGGGGGGGGGGG.............GGGGGGGGGGGGGGGGGGGGGGGGGGGGGGGGGGGGGG.........GGGGG..................................GGG........GGG..........GGG........
..............G.x.G........................GGGGGGGGGGGGGGG............................................................GGGGG..................................GGG........GGG..........GGG........
............GGGGGGGGG.................................................................................................GGGGG..................................GGG........GGG..........GGG........
............GGGGGGGGG.................................................................................................GGGGGGGGGGGGGGGGGGGGGGGGGGGGGGGGGG.....GGG........GGG..........GGG........
..............GGGGG...............................................G...........................GGGGGGGGGG..............GGGGGGGGGGGGGGGGGGGGGGGGGGGGGGGGGG.....GGG........GGG..........GGG........
...............GGG................................................G...........................GGGGGGGGGG..............GGGGG..................................GGG........GGG..........GGG........
...............GGG................................................G...........................GGGGGGGGGG..............GGGGG..................................GGG........GGG..........GGG........
.......GGGG...........GGGG........................................G...........................GGGGGGGGGG..............GGGGG..................................GGG........GGG..........GGG........
.......GGGG...........GGGG................................GGGGGGGGGGGGGGGG............................................GGGGG.....GGGGGGGGGGGGGGGGGGGGGGGGGGGGGGGG........GGG..........GGG........
....GGGGGGG.....x.....GGGGGGG.............................GGGGGGGGGGGGGGGG..............G.............................GGGGG.....GGGGGGGGGGGGGGGGGGGGGGGGGGGGGGGG........GGG..........GGG........
....GGGGGGG...........GGGGGGG.............................GGGGGGGGGGGGGGGG..............G.......................................GG...........................GGG........GGG..........GGG........
....GGGGGGG...........GGGGGGG.............................GGGGGGGGGGGGGGGG..............G.......................................GG...........................GGG........GGG..........GGG........
....GGGGGGG...........GGGGGGG.......................................................GGGGGGGGGGGGGGGGGG..........................GG...........................GGG........GGG..........GGG........
GGGGGGGGGGGGGGGGGGGGGGGGGGGGGGGGGGGGGGGGGGGG........................................GGGGGGGGGGGGGGGGGG.............................G..G..G...................GGG........GGG..........GGG........
GGGGGGGGGGGGGGGGGGGGGGGGGGGGGGGGGGGGGGGGGGGG........................................GGGGGGGGGGGGGGGGGG.......................................................GGGGGGGGGGGGGG..........GGGGGGGGGGG
GGGGGGGGGGGGGGGGGGGGGGGGGGGGGGGGGGGGGGGGGGGG.................................................................................................................GGGGGGGGGGGGGG..........GGGGGGGGGGG
GGGGGGGGGGGGGGGGGGGGGGGGGGGGGGGGGGGGGGGGGGGG..........................................................................GGGGGGGGGGGGGGGGGGGGG..................GGG................................
GGGGGGGG...GGGGGGGGGGGGGGGGGGGGGGGGG.....GGG..................G.......................................................GGGGGGGGGGGGGGGGGGGGG..................GGG................................
GGGGGGGG...GGGGGGGGGGGGGGGGGGGGGGGGG.....GGG...............GGGGGGGGGG.................................................GGGGGGGGGGGGGGGGGGGGG..................GGG................................
GGGGGGGG...GGGGGGGGGGGGGGGGGGGGGGGGG.....GGG...............GGGGGGGGGG.................................................GGGGGGGGGGGGGGGGGGGGG..................GGGGGGGGGGGGGGGGGGGGGGGGGGGGGGGGGGG
GGGGGGGG...GG...GGG...GGG...GGG...GG.....GGG..........................................................................GGGGGGGGGGGGGGGGGGGGG..................GGGGGGGGGGGGGGGGGGGGGGGGGGGGGGGGGGG
GGGGGGGG.................................GGG......................................................................GGGGGGGGGGGGGGGGGGGGGGGGG..................GGGGGGGGGGGGGGGGGGGGGGGGGGGGGGGGGGG
GGGGGGGG.................................GGG......................................................................GGGGGGGGGGGGGGGGGGGGGGGGG..................GGGGGGGGGGGGGGGGGGGGGGGGGGGGGGGGGGG
.......G.................................GGG............................................GGGGGGGGGGGGG.................GGGGGGGGGGGGGGGGGGGGG..................GGGGGGGGGGGGGGGGGGGGGGGGGGGGGGGGGGG
.......G...GGGGG...GGG...GGG...GGGGG.....GGGGGGGGGGG....................................GGGGGGGGGGGGG.................GGGGGGGGGGGGGGGGGGGGG..................GGG..........................G.....
.......G...GGGGGGGGGGGGGGGGGGGGGGGGG.....GGGGGGGGGGG..................................................................GGGGGGGGGGGGGGGGGGGGG..................GGG..........................G.....
.......G...GGGGGGGGGGGGGGGGGGGGGGGGG.....GGG..........................................................................GGGGGGGGGGGGGGGGGGGGG..................GGGGGG...GG....GG....G...GG..G.....
.......G...GGGGGGGGGGGGGGGGGGGGGGGGG.....GGG..........................................................................GGGGGGGGGGGGGGGGGGGGG..................GGG......................GG..G.....
...........GGGGGGGGGGGGGGGGGGGGGGGGG.....GGG..................................................t.......................GGGGGGGGGGGGGGGGGGGGG..................GGG......................GG........
GGGGGGGGGGGGGGGGGGGGGGGGGGGGGGGGGGGGGGGGGGGGGGGGGGGGGGGGGGGGGGGG.......................GGGGGGGGGGGGGGG................GGGGGGGGGGGGGGGGGGGGG..................GGGGGGGGGGGGGGGGGGGGGGGGGGGGGGGGGGG
GGGGGGGGGGGGGGGGGGGGGGGGGGGGGGGGGGGGGGGGGGGGGGGGGGGGGGGGGGGGGGGG.......................GGGGGGGGGGGGGGG................GGGGGGGGGGGGGGGGGGGGG..................GGGGGGGGGGGGGGGGGGGGGGGGGGGGGGGGGGG
GGGGGGGGGGGGGGGGGGGGGGGGGGGGGGGGGGGGGGGGGGGGGGGGGGGGGGGGGGGGGGGG.......................GGGGGGGGGGGGGGG................GGGGGGGGGGGGGGGGGGGGG.....GGGGGGGG.....GGGGGGGGGGGGGGGGGGGGGGGGGGGGGGGGGGG